[
.vvvvvvvvvvvvvvvvvvvvvvvvv.|
>                         <|
>                         <|
>                         <|
>                         <|
>     ...      .....      <|
>    ....       ....      <|
>     ....      ....> .   <|
..     ..       ....>     <|
>      ..      .....      <|
>     ....      ....    . <|
.    ....       ....      <|
..    ...      .....      <|
...    ..       .....      |
....   ...      ....       |
>      ....     ....    .  |
      ...>     .....      <|
    .....^^ @ ^.....^^^^^^^|
]
/