[
               ^^          |
             ^^..^^        |
    ^^^     ^..  ..^       |
   ^...^   ^.      .^      |
  ^.v.v.^^^.        .^     |
 ^.  v  ...         <.     |
^.       .          <.     |
.        .          <.     |
>                    .     |
>     -        -     .     |
> -      .           .     |
>        .  .        .     |
>  -     .> v        .     |
>        .>       - <.     |
        -.>         <.     |
    -    .> @        .     |
   -     .> -   -          |
   ^^^^^^.^^^^^^^^^        |
]
/